################
#             P#
#       ########
#              #
#      ##      #
#      ##      #
#              #
###            #
##             #
#       ####/###
#       #      #
#       #      #
#       /      #
#       ########
#              #
################