################
#              #
#              #
#########      #
#   #   #      #
#   #   #      #
#   #   #      #
#   #   #   ####
#   /   /     P#
#   #   #   ####
#   #   #      #
#   #   #      #
#########      #
#              #
#              #
################